NO ./textures/North64.xpm
SO ./textures/South64.xpm
WE ./textures/West64.xpm
EA ./textures/East64.xpm

C 102,255,255
F 64,64,64

        1111111111111111111111111
        1000000000110000000000001
        1011000001110000000000001
        1001000000000000000000001
111111111011000001110000000000001
100000000011000001110111111111111
11110111111111011100000010001
11110111111111011101010010001
11000000110101011100000010001
10000000000000001100000010001
10000000000000001101010000001
110000011101010000000000W0111
11110111 11101011101111000001
11111111 1111111 111111111111
