
C                 102,255,255
NO ./textures/North64.xpm
SO    ./textures/South64.xpm
WE ./textures/West64.xpm
EA ./textures/East64.xpm
F 64,64,64

1 11111111111111111111111111111111111111
  11000000000000000000000000000000000001
1110111100000000000111111111000000110001
1000000100000000000000000001000000010001
1000000111111100000000111111111100010001
1000000000000100000000100000000100010001
1000000000000100000000100000000100010001
1000000000000111110000111110000111110001
1000000000000000010000000010000000000001
1000000000000000010000000010000000000001
1000000000111000010000111110000111110001
1000000000100000010000000010000000100001
1000000000100000010000000010000000100001
1000111100100000011111111110000000100001
1000100000100000000000000000000000100001
1000100000100000000000000000000000100001
1000111111111110000000000111111111101111
10000000000000000000S0000100000000001
1000000000000000001000000100000000001111
1000000000000000000000000111110000000001
1000000000000000000000000000010000000001
1000000000000000000000000000010000000001
1111100000111110111000111110011111000001
1000100000100000001000100000000000000001
1000100000100000001000100000000000000001
1000100000111111111000111110000111111001
1000100000000000000000000000000000000001
1000100000000000000000000000000000000001
1000111111111000000111110000111110000001
1000000000000000000000000000000100000001
1000000000000000000000000000000100000001
1111111000111111111000111111111100000001
10000000001       1000000000000000000001
10000000001       1000000000000000000001
1000000000111111111111111000000000000001
1000000000000000000000000000000000000001
1000000000000000000000000000000000000001
100000000000000000000000000000000000001
1000000000000000000000000000000000000001
1000000000000000010000000000000000000001
100000000000000000000000000000000000001
111111111111111111111111111111111111111
